XXXXXXXXXXXXXXXXXXXXX
XS....X.....X.......X
X.XXX.X.XXX.X.XXXXX.X
X.X...X...X:..X.X...X
X.XXXXXXX.XXX.X.X.XXX
X...X...X...X...X.X.X
XXX.X.XXX.X.XXXXX.X.X
X.....X...X...X.....X
X.XXXXX.X.XXXXX.XXXXX
X.......X...X......:X
XXXXXXXXXXXXXXXXXXXXX
